ext {

    // Plugins
    AndroidPlugin = "com.android.application"
    KotlinAndroidPlugin = "kotlin-android"
    KotlinAndroidExPlugin = "org.jetbrains.kotlin.android"
    KotlinKaptPlugin = "kotlin-kapt"
    AndroidLibraryPlugin = "com.android.library"
    FirebasePlugin = "com.google.gms.google-services"
    navigationPlugin = "androidx.navigation.safeargs.kotlin"
    EasyLauncherPlugin = "com.akaita.android.easylauncher"
    RealmPlugin = "realm-android"
    Hilt = "dagger.hilt.android.plugin"
    CrashlyticsPlugin = "com.google.firebase.crashlytics"

    //Android Details
    compileSdkV = 31
    BuildToolsVersion = "29.0.0"
    HttpLegacyEnabled = "org.apache.http.legacy"
    applicationPackage = "#{PackageName}"
    AndroidRunnerArgument = "listener"
    KotlinSource = "src/main/kotlin"
    EasyLauncherForground = "@mipmap/ic_launcher_foreground"
    LeakCanaryListener = "com.squareup.leakcanary.FailTestOnLeakRunListener"
    minSdkV = 24
    MultiDexMergeEnabled = true
    ApplicationVersion = "1.0"
    VersionCode = 1
    renderscriptTargetApi = 26
    renderscriptSupportModeEnabled = true
    AndroidTest = "androidx.test.runner.AndroidJUnitRunner"
    ApplicationBuildType = "Testing"
    ProguardFile = "proguard-android-optimize.txt"
    Proguard = "proguard-rules.pro"
}